111111
1P0001
1E0001
1CCCC1
111111